00000010010000000011010101110110000010000001001100
11101100000100000010011001110110000010000001001100
11100001101100111100010101110110000010000m01001100
11100001001000000010000111110010010010000001001100
10000000000110110000011100000000000000000001001100
10000001000001110001100000110110000000000001001100
10111111000000110001101100010110000010000001001100
10110001000000110000001111110110000010000001001100
10010e01000000110001111111110110000010000001001100
10000001000000110001111111110110000010000001001100
10000001000000110001111111110110000010000001001100
10000001000000110001111111110110000010000001001100
10000001000000110001111111110110000010000001001100
10000001000000110001111111110110000010000001001100