000000100100000m001101010
1110110000010000001001100
1110000110110011110001010
1110000100100000001000011
1000000000011011000001111
1000000100000111000111111
1011111100000011000111111
1011000100000011000111111
10010e0100000011000111111
1000000100000011000111111