0000000000000000
0000000m00000000
1111111011111111
0000000000000000
1111111011111111
0000000000000000
1111111011111111
0000000000000000
1111111011111111
0000000000000000
1111111011111111
0000000000000000
1111111011111111
000000000000000e
1111111011111111
0000000000000000