000m0010010000
11100010000000
11100000101100
11100001000000
1000000100000e