00000010010m00
11101100000100
11100001101100
11100001001000
1000e001000000